[
    {
        "floor": 5,
        "aparts_at_the_floor": [
            "|  369   |  370   |  371   |  372   |",
            "|  389   |  390   |  391   |  392   |",
            "|  409   |  410   |  411   |  412   |",
            "|  429   |  430   |  431   |  432   |",
            "|  449   |  450   |  451   |  452   |"
        ]
    },
    {
        "floor": 4,
        "aparts_at_the_floor": [
            "|  365   |  366   |  367   |  368   |",
            "|  385   |  386   |  387   |  388   |",
            "|  405   |  406   |  407   |  408   |",
            "|  425   |  426   |  427   |  428   |",
            "|  445   |  446   |  447   |  448   |"
        ]
    },
    {
        "floor": 3,
        "aparts_at_the_floor": [
            "|  361   |  362   |  363   |  364   |",
            "|  381   |  382   |  383   |  384   |",
            "|  401   |  402   |  403   |  404   |",
            "|  421   |  422   |  423   |  424   |",
            "|  441   |  442   |  443   |  444   |"
        ]
    },
    {
        "floor": 2,
        "aparts_at_the_floor": [
            "|  357   |  358   |  359   |  360   |",
            "|  377   |  378   |  379   |  380   |",
            "|  397   |  398   |  399   |  400   |",
            "|  417   |  418   |  419   |  420   |",
            "|  437   |  438   |  439   |  440   |"
        ]
    },
    {
        "floor": 1,
        "aparts_at_the_floor": [
            "|  353   |  354   |  355   |  356   |",
            "|  373   |  374   |  375   |  376   |",
            "|  393   |  394   |  395   |  396   |",
            "|  413   |  414   |  415   |  416   |",
            "|  433   |  434   |  435   |  436   |"
        ]
    }
]